2
20
4 3
50 50
0 0 0 0 0 0 0 0 0 0 0 0 0 0 0 0 0 0 0 0 0 0 0 0 0 0 0 0 0 0 0 0 0 0 0 0 0 0 0 0 0 0 0 0 0 0 0 0 0 0
0 0 0 0 0 0 0 0 0 0 0 0 0 0 0 0 0 0 0 0 0 0 0 0 0 0 0 0 0 0 0 0 0 0 0 0 0 0 0 0 0 0 0 0 0 0 0 0 0 0
0 0 0 0 0 0 0 0 0 0 0 0 0 0 0 0 0 0 0 0 0 0 0 0 0 0 0 0 0 0 0 0 0 0 0 0 0 0 0 0 0 0 0 0 0 0 0 0 0 0
0 0 0 0 0 0 0 0 0 0 0 0 0 0 0 0 0 0 0 0 0 0 0 0 0 0 0 0 0 0 0 0 0 0 0 0 0 0 0 0 0 0 0 0 0 0 0 0 0 0
0 0 0 0 0 0 0 0 0 0 0 0 0 0 0 0 0 0 0 0 0 0 0 0 0 0 0 0 0 0 0 0 0 0 0 0 0 0 0 0 0 0 0 0 0 0 0 0 0 0
0 0 0 0 0 0 0 0 0 0 0 0 0 0 0 0 0 0 0 0 0 - - - - - - - - 0 0 0 0 0 0 0 0 0 0 0 0 0 0 0 0 0 0 0 0 0
0 0 0 0 0 0 0 0 0 0 0 0 0 0 0 0 0 0 0 0 - b x x x x x b x - - - - - 0 0 0 0 0 0 0 0 0 0 0 0 0 0 0 0
0 0 0 0 0 0 0 0 0 0 0 0 0 0 0 0 0 0 0 0 - b b b b b b b b b b x x x - - 0 0 0 0 0 0 0 0 0 0 0 0 0 0
0 0 0 0 0 0 0 0 0 0 0 0 0 0 0 0 0 0 0 0 - c c c c c c c i b b b b b b x - 0 0 0 0 0 0 0 0 0 0 0 0 0
0 0 0 0 0 0 0 0 0 0 0 0 0 0 0 0 0 0 0 0 - c c c c c c c c i c c b b b - 0 0 0 0 0 0 0 0 0 0 0 0 0 0
0 0 0 0 0 0 0 0 0 0 0 0 0 0 0 0 0 0 0 0 - c c c c c c c c c c c c b - 0 0 0 0 0 0 0 0 0 0 0 0 0 0 0
0 0 0 0 0 0 0 0 0 0 0 0 0 0 0 0 0 0 0 0 - c c c c c c c c c c c c b - 0 0 0 0 0 0 0 0 0 0 0 0 0 0 0
0 0 0 0 0 0 0 0 0 0 0 0 0 0 0 0 0 0 0 0 - c c c c c - - c c c c i b b - 0 0 0 0 0 0 0 0 0 0 0 0 0 0
0 0 0 0 0 0 0 0 0 0 0 0 0 0 0 0 0 0 0 0 - c c - - - 0 0 - - c c c i i b - - 0 0 0 0 0 0 0 0 0 0 0 0
0 0 0 0 0 0 0 0 0 0 0 0 0 0 0 0 0 0 0 0 0 - - 0 0 0 0 0 0 0 - - c c c c i b - 0 0 0 0 0 0 0 0 0 0 0
0 0 0 0 0 0 0 0 0 0 0 0 0 0 0 0 0 0 0 0 0 0 0 0 0 0 0 0 0 0 0 0 - - - c c i c - 0 0 0 0 0 0 0 0 0 0
0 0 0 0 0 0 0 0 0 0 0 0 0 0 0 0 0 0 0 0 0 0 0 0 0 0 0 0 0 0 0 0 0 0 - - c c c - 0 0 0 0 0 0 0 0 0 0
0 0 0 0 0 0 0 0 0 0 0 0 0 0 0 0 0 0 0 0 0 0 0 0 0 0 0 0 0 0 0 0 0 0 - - c c - 0 0 0 0 0 0 0 0 0 0 0
0 0 0 0 0 0 0 0 0 0 0 0 0 0 0 0 0 0 0 0 0 0 0 0 0 0 0 0 0 0 0 0 - - - - - - 0 0 0 0 0 0 0 0 0 0 0 0
0 0 0 0 0 0 0 0 0 0 0 0 0 0 0 0 0 0 0 0 0 0 0 0 0 0 0 0 0 0 0 - - - - - - 0 0 0 0 0 0 0 0 0 0 0 0 0
0 0 0 0 0 0 0 0 0 0 0 0 0 0 0 0 0 0 0 0 0 0 0 0 0 0 0 0 0 0 - - - - - 0 0 0 0 0 0 0 0 - - 0 0 0 0 0
0 0 0 0 0 0 0 0 0 0 0 0 0 0 0 0 0 0 0 0 0 0 0 0 0 0 0 0 0 0 0 0 0 - - - 0 0 0 0 - - - - - 0 0 0 0 0
0 0 0 0 0 0 0 0 0 0 0 0 0 0 0 0 0 0 0 0 0 0 0 0 0 0 0 0 0 - - - - - - - - 0 - - - - - - - 0 0 0 0 0
0 0 0 0 0 0 0 0 0 0 0 0 0 0 0 0 0 0 0 0 0 0 0 0 0 0 - - - b x x x b b b c - b b - - - - 0 0 0 0 0 0
0 0 0 0 0 0 0 0 0 0 0 0 0 0 0 0 0 0 0 0 0 0 0 0 - - c c c c i - - b b - - b x b - - - - 0 0 0 0 0 0
0 0 0 0 0 0 0 0 0 0 0 0 0 0 0 0 0 0 0 0 0 0 0 - c b b b x x b b b - - - b x b b c c - - 0 0 0 0 0 0
0 0 0 0 0 0 0 0 0 0 - - - - - - - - 0 0 0 0 - c b b - - - - - b b b - b x x b c c - - 0 0 0 0 0 0 0
0 0 0 0 0 0 0 - - - - - - - b b b b - - 0 0 - - - i c c - - - - - - - b x b b c - b c - 0 0 0 0 0 0
0 0 0 0 0 0 - - - - - - - b x x x b b i - - b b b b b b b b c - - - b b b b c c - b c - 0 0 0 0 0 0
0 0 0 0 0 0 0 0 - - - - - b b b b b i c i b b x x x b b b b b b c - b b b c c - b b b i - 0 0 0 0 0
0 0 0 0 0 0 0 0 0 0 - - - c c c c c - i b x x x x x x x b b b b b b b b c c - - b b b b c - 0 0 0 0
0 0 0 0 0 0 0 0 0 0 0 0 0 - - - - - c b b x x x x x x x b b b b b b b c c - b b b b b b c - 0 0 0 0
0 0 0 0 0 0 0 0 0 0 0 0 0 0 0 0 0 - b b b x x x x x x x b b b b b b b c - b b b b b b b b c - 0 0 0
0 0 0 0 0 0 0 0 0 0 0 0 0 0 0 0 - b b b b b x x x x b b b b b b b b b b c - b b b b b b b c - 0 0 0
0 0 0 0 0 0 0 0 0 0 0 0 0 0 0 0 - b b b b b b b b b b b b b b b b b b b c - b i c b b b b c c - 0 0
0 0 0 0 0 0 0 0 0 0 0 0 0 0 0 0 - b b b b b b b b b b b b b b b b b b b c - i c c i b b b c c - 0 0
0 0 0 0 0 0 0 0 0 0 0 0 0 0 0 - b b - - i b b b b b b b b b b b b b b b b b - c c c c c c c c - 0 0
0 0 0 0 0 0 0 0 0 0 0 0 0 0 0 - b - - 0 - b b b b b b b b c - - b b b b b b - c c c c c c c c - 0 0
0 0 0 0 0 0 0 0 0 0 0 0 0 0 - b b - - - - b b b b b b b b - - 0 - b b b b b - c c c c c c c - 0 0 0
0 0 0 0 0 0 0 0 0 0 0 0 - - - b b i - - b b b b b b b b b - - - - b b b b b - c c - c c c - - 0 0 0
0 0 0 0 0 0 0 0 0 0 0 - c c - b b b b b b b x x b b b b b b - - b b b b b b - i i - - - - - 0 0 0 0
0 0 0 0 0 0 0 0 0 0 0 - - - - b b b b b b b - b b b b b b b b b b b b b b - b b c - c c - c - 0 0 0
0 0 0 0 0 0 0 0 0 - - i b x - b b b b b b b b b b b b b b b b b b b b - - x b b - - - - - - - 0 0 0
0 0 0 0 0 0 0 0 - b b b b b b - b b i b b b b b b b b b b b b b - - - - x x b c - 0 0 0 0 0 0 0 0 0
0 0 0 0 0 0 0 0 - c - c c c c c - - c c c b b i b b b c b b b - b b b b b b c - 0 0 0 0 0 0 0 0 0 0
0 0 0 0 0 0 0 0 0 - - - - - - - - - - - - - - - - - - - - - - b - b - b c - - 0 0 0 0 0 0 0 0 0 0 0
0 0 0 0 0 0 0 0 0 0 0 0 0 0 0 0 0 0 0 0 0 0 0 0 0 0 0 0 0 0 - - - - - - - 0 0 0 0 0 0 0 0 0 0 0 0 0
0 0 0 0 0 0 0 0 0 0 0 0 0 0 0 0 0 0 0 0 0 0 0 0 0 0 0 0 0 0 0 0 0 0 0 0 0 0 0 0 0 0 0 0 0 0 0 0 0 0
0 0 0 0 0 0 0 0 0 0 0 0 0 0 0 0 0 0 0 0 0 0 0 0 0 0 0 0 0 0 0 0 0 0 0 0 0 0 0 0 0 0 0 0 0 0 0 0 0 0
0 0 0 0 0 0 0 0 0 0 0 0 0 0 0 0 0 0 0 0 0 0 0 0 0 0 0 0 0 0 0 0 0 0 0 0 0 0 0 0 0 0 0 0 0 0 0 0 0 0
