8
10
0 2
20 20
x x x x x - 0 0 0 0 0 0 0 0 - x x x x x
x b 0 0 0 0 0 0 0 c c 0 0 0 0 0 0 0 b x
x 0 b 0 0 0 0 0 0 0 0 0 0 0 0 0 0 b 0 x
x 0 0 b 0 0 0 0 - - - - 0 0 0 0 b 0 0 x
x 0 0 0 b 0 0 0 0 0 0 0 0 0 0 b 0 0 0 x
- 0 0 0 0 b 0 0 0 0 0 0 0 0 b 0 0 0 0 -
0 0 0 0 0 0 b 0 2 x x 1 0 b 0 0 0 0 0 0
0 0 0 0 0 0 0 x 0 0 0 0 x 0 0 0 0 0 0 0
0 0 0 - 0 0 3 0 0 2 1 0 0 8 0 0 - 0 0 0
0 c 0 - 0 0 x 0 3 b b 8 0 x 0 0 - 0 c 0
0 c 0 - 0 0 x 0 4 b b 7 0 x 0 0 - 0 c 0
0 0 0 - 0 0 4 0 0 5 6 0 0 7 0 0 - 0 0 0
0 0 0 0 0 0 0 x 0 0 0 0 x 0 0 0 0 0 0 0
0 0 0 0 0 0 b 0 5 x x 6 0 b 0 0 0 0 0 0
- 0 0 0 0 b 0 0 0 0 0 0 0 0 b 0 0 0 0 -
x 0 0 0 b 0 0 0 0 0 0 0 0 0 0 b 0 0 0 x
x 0 0 b 0 0 0 0 - - - - 0 0 0 0 b 0 0 x
x 0 b 0 0 0 0 0 0 0 0 0 0 0 0 0 0 b 0 x
x b 0 0 0 0 0 0 0 c c 0 0 0 0 0 0 0 b x
x x x x x - 0 0 0 0 0 0 0 0 - x x x x x
4 8 6 <-> 15 8 2
4 9 6 <-> 15 9 2
4 10 6 <-> 15 10 2
4 11 6 <-> 15 11 2
4 8 5 <-> 15 9 1
4 9 5 <-> 15 10 1
4 10 5 <-> 15 11 1
4 9 7 <-> 15 8 3
4 10 7 <-> 15 9 3
11 4 7 <-> 15 10 3 
8 4 0 <-> 8 15 4
9 4 0 <-> 9 15 4
10 4 0 <-> 10 15 4
11 4 0 <-> 11 15 4
8 4 1 <-> 9 15 5
9 4 1 <-> 10 15 5
10 4 1 <-> 11 15 5
9 4 7 <-> 8 15 3
10 4 7 <-> 9 15 3
	





